0  0  2  2  0  0  2  2  0  0  0  0  0  0  0  0  0  0  0
0  2  5  5  2  2  5  5  2  0  0  0  0  0  0  0  0  0  0
2  5 10 10  5  5 10 10  5  2  0 10 10 10 10 10  0  0  0
2  5 10 10  5  5 10 10  5  2  0  0  0  0  0 10 10  0  0
2  5 10 10  5  5 10 10  5  2  0  0  0  0  0 10 10  0  0
2  5 10 10 10 10 10 10  5  2  0  0 10 10 10 10  0  0  0
0  2  5 10 10 10 10 10  5  2  0 10 10  0  0  0  0  0  0
0  0  2  5  5  5 10 10  5  2  0 10 10  0  0  0  0  0 60
0  0 -9 20 20  5 10 10  5  2  0 10 10 10 10 10 10  0 40
0 -5 -5  0  0  2  5  5  2  0  0  0  0  0  0  0  0 20 20
0  0  0  0  0  0  2  2  0  0  0 30 20 10  0  0  0 -10 -10
